111111111111111
100000010000001
101101000101101
100001010100001
101101010101101
101000000000101
101011222110101
100001333100001
101101111101101
100100000001001
110001111100011
100100010001001
101111000111101
100000010000001
111111111111111
